"","GEOID","NAME","TotPop","White","Black","AI","Asian","Pac_il","Other_Race","Multi_Race","MedInc","Pop25","HS","GED","Assoc","Bach","Mast","ProfDeg","Doct","TotalHouse","Occupied","Vacant","TotalOcc","Own","Rent"
"1","42101006600","Census Tract 66, Philadelphia County, Pennsylvania",3536,208,2969,10,244,0,47,58,27049,2074,963,185,154,111,0,0,0,1635,1329,306,1329,448,881
"2","42101018802","Census Tract 188.02, Philadelphia County, Pennsylvania",4200,956,1294,0,0,0,1178,772,31523,1729,590,115,154,38,225,0,0,1494,1138,356,1138,339,799
"3","42101011100","Census Tract 111, Philadelphia County, Pennsylvania",3829,129,3532,0,0,0,0,168,43235,2471,1005,100,214,162,64,0,0,1943,1340,603,1340,822,518
"4","42101025300","Census Tract 253, Philadelphia County, Pennsylvania",4792,615,4034,0,63,0,0,80,46769,3239,1057,139,347,374,472,0,18,2269,2022,247,2022,1248,774
"5","42101033300","Census Tract 333, Philadelphia County, Pennsylvania",3790,2615,416,0,427,0,54,278,49505,3148,1137,109,196,610,262,33,18,1800,1625,175,1625,971,654
"6","42101024800","Census Tract 248, Philadelphia County, Pennsylvania",2350,45,2163,0,0,12,75,55,37667,1337,371,194,157,142,67,0,0,896,822,74,822,619,203
"7","42101011500","Census Tract 115, Philadelphia County, Pennsylvania",4606,310,4032,28,0,0,14,222,74815,3238,866,14,375,652,236,25,0,1875,1742,133,1742,1341,401
"8","42101001102","Census Tract 11.02, Philadelphia County, Pennsylvania",2669,2162,146,0,182,48,0,131,133906,2200,41,0,66,964,525,346,215,1688,1459,229,1459,767,692
"9","42101025900","Census Tract 259, Philadelphia County, Pennsylvania",4414,100,4192,0,6,0,110,6,47144,2990,1039,73,318,501,231,80,0,2118,2023,95,2023,1521,502
"10","42101032900","Census Tract 329, Philadelphia County, Pennsylvania",3702,2109,722,0,320,0,345,206,41563,2594,847,335,146,318,47,6,7,2033,1850,183,1850,875,975
"11","42101037200","Census Tract 372, Philadelphia County, Pennsylvania",3986,2045,260,0,1212,0,70,399,60643,3099,1015,41,217,523,162,25,10,1838,1763,75,1763,1349,414
"12","42101000403","Census Tract 4.03, Philadelphia County, Pennsylvania",965,836,27,4,63,0,0,35,165890,942,35,27,57,377,308,110,0,809,694,115,694,402,292
"13","42101000500","Census Tract 5, Philadelphia County, Pennsylvania",2977,1285,964,37,425,0,40,226,51801,2567,558,169,54,502,282,213,100,1355,1144,211,1144,61,1083
"14","42101028800","Census Tract 288, Philadelphia County, Pennsylvania",5204,1002,951,0,504,0,1688,1059,48356,3342,1248,195,88,36,146,0,0,1770,1708,62,1708,1218,490
"15","42101014500","Census Tract 145, Philadelphia County, Pennsylvania",2170,225,1535,0,50,0,229,131,NA,1254,428,70,67,62,55,0,31,894,813,81,813,225,588
"16","42101009300","Census Tract 93, Philadelphia County, Pennsylvania",5171,305,4509,0,201,0,6,150,29597,3256,878,164,132,457,171,44,0,2602,2156,446,2156,1308,848
"17","42101021600","Census Tract 216, Philadelphia County, Pennsylvania",2449,1665,252,13,84,0,104,331,84095,2015,511,62,41,597,283,67,90,1251,1213,38,1213,415,798
"18","42101024700","Census Tract 247, Philadelphia County, Pennsylvania",4480,302,3997,7,18,0,5,151,35120,2711,909,138,370,329,180,8,90,1991,1721,270,1721,844,877
"19","42101025400","Census Tract 254, Philadelphia County, Pennsylvania",4301,488,3604,0,27,0,21,161,62000,3155,746,72,250,729,339,22,61,2128,1964,164,1964,1276,688
"20","42101001500","Census Tract 15, Philadelphia County, Pennsylvania",3231,1918,805,0,346,0,0,162,93203,2525,370,14,109,866,444,181,208,1618,1478,140,1478,847,631
"21","42101016902","Census Tract 169.02, Philadelphia County, Pennsylvania",3276,0,2840,0,0,0,73,363,21114,2871,1326,99,143,217,71,0,0,2506,1992,514,1992,987,1005
"22","42101980702","Census Tract 9807.02, Philadelphia County, Pennsylvania",0,0,0,0,0,0,0,0,NA,0,0,0,0,0,0,0,0,0,0,0,0,0,0
"23","42101019502","Census Tract 195.02, Philadelphia County, Pennsylvania",3870,1087,178,0,26,0,2245,334,23931,2122,531,265,101,112,13,53,0,1269,1181,88,1181,689,492
"24","42101009500","Census Tract 95, Philadelphia County, Pennsylvania",3436,77,3359,0,0,0,0,0,29550,2240,1157,111,102,178,9,28,0,1772,1569,203,1569,626,943
"25","42101000600","Census Tract 6, Philadelphia County, Pennsylvania",1465,1048,153,0,240,0,0,24,90119,1291,73,6,0,520,279,294,83,1300,1008,292,1008,18,990
"26","42101008102","Census Tract 81.02, Philadelphia County, Pennsylvania",4636,439,3644,0,29,0,0,524,41900,3449,1165,109,271,599,109,0,0,2414,2022,392,2022,1348,674
"27","42101006200","Census Tract 62, Philadelphia County, Pennsylvania",4252,385,3669,0,198,0,0,0,38006,2930,957,172,332,455,0,26,0,1653,1544,109,1544,617,927
"28","42101031501","Census Tract 315.01, Philadelphia County, Pennsylvania",7359,4096,190,0,2716,0,179,178,52792,4637,1615,215,495,787,228,48,0,2487,2290,197,2290,1505,785
"29","42101032100","Census Tract 321, Philadelphia County, Pennsylvania",3710,1685,893,0,35,0,539,558,43525,2477,770,200,209,207,355,0,0,1745,1637,108,1637,712,925
"30","42101026700","Census Tract 267, Philadelphia County, Pennsylvania",7697,2,7416,0,0,0,0,279,49097,4874,1502,212,506,589,106,0,39,2946,2699,247,2699,1807,892
"31","42101016200","Census Tract 162, Philadelphia County, Pennsylvania",2447,457,336,0,195,0,1240,219,33140,1589,311,39,45,333,79,26,0,892,765,127,765,397,368
"32","42101000701","Census Tract 7.01, Philadelphia County, Pennsylvania",1682,1343,21,0,291,0,27,0,87776,1437,41,0,77,494,346,308,94,1572,1279,293,1279,302,977
"33","42101004202","Census Tract 42.02, Philadelphia County, Pennsylvania",5592,4012,151,0,921,0,371,137,64441,4211,1404,146,282,483,393,12,23,2191,2024,167,2024,1617,407
"34","42101013300","Census Tract 133, Philadelphia County, Pennsylvania",3234,1921,734,0,272,0,115,192,92222,2611,175,33,160,1007,584,355,118,2072,1752,320,1752,332,1420
"35","42101020200","Census Tract 202, Philadelphia County, Pennsylvania",4515,311,3727,3,0,0,21,453,31347,3471,1278,74,132,507,0,73,0,2372,1943,429,1943,916,1027
"36","42101014300","Census Tract 143, Philadelphia County, Pennsylvania",1970,1680,121,0,91,0,47,31,104883,1761,250,12,105,733,296,130,75,1002,933,69,933,510,423
"37","42101014700","Census Tract 147, Philadelphia County, Pennsylvania",2771,1000,1255,0,183,0,55,278,14962,697,154,30,41,166,21,0,0,1482,1208,274,1208,191,1017
"38","42101010900","Census Tract 109, Philadelphia County, Pennsylvania",2787,428,2197,12,91,0,36,23,29331,1475,481,117,112,221,100,11,35,1183,1053,130,1053,229,824
"39","42101028700","Census Tract 287, Philadelphia County, Pennsylvania",2688,620,559,0,27,0,1200,282,23160,1289,406,54,44,45,0,0,24,869,783,86,783,366,417
"40","42101013602","Census Tract 136.02, Philadelphia County, Pennsylvania",4162,3204,232,0,207,0,0,519,103426,3343,174,25,97,1287,832,461,139,2054,1990,64,1990,1064,926
"41","42101008801","Census Tract 88.01, Philadelphia County, Pennsylvania",2069,973,196,8,517,0,187,188,36250,452,0,0,0,242,104,37,63,553,356,197,356,0,356
"42","42101034900","Census Tract 349, Philadelphia County, Pennsylvania",5629,2997,1584,0,279,0,344,425,56073,3956,1550,247,339,420,296,30,0,2359,2245,114,2245,1523,722
"43","42101027700","Census Tract 277, Philadelphia County, Pennsylvania",5179,109,4699,0,129,0,24,218,29574,4039,1227,713,111,340,77,0,0,2756,2393,363,2393,1402,991
"44","42101026302","Census Tract 263.02, Philadelphia County, Pennsylvania",4804,159,4591,0,53,0,0,1,56679,3728,721,157,314,586,342,38,0,2182,1984,198,1984,1428,556
"45","42101030200","Census Tract 302, Philadelphia County, Pennsylvania",8697,1861,4305,27,161,0,1486,857,56122,5338,1977,413,295,361,179,0,107,2962,2817,145,2817,1873,944
"46","42101033000","Census Tract 330, Philadelphia County, Pennsylvania",10074,4933,1747,26,682,0,1340,1346,46884,5748,1473,520,386,633,388,64,0,3221,3148,73,3148,1852,1296
"47","42101001204","Census Tract 12.04, Philadelphia County, Pennsylvania",2958,2418,122,5,238,20,0,155,82115,2436,78,19,80,1076,378,374,202,2104,1732,372,1732,545,1187
"48","42101016400","Census Tract 164, Philadelphia County, Pennsylvania",4378,406,1745,0,131,0,1925,171,17389,2794,769,302,95,86,0,14,0,2041,1782,259,1782,464,1318
"49","42101020000","Census Tract 200, Philadelphia County, Pennsylvania",1126,57,551,0,132,0,386,0,11955,547,180,24,35,81,27,6,0,669,487,182,487,167,320
"50","42101036400","Census Tract 364, Philadelphia County, Pennsylvania",1032,841,137,0,8,0,21,25,110139,1016,365,44,63,102,54,0,44,318,294,24,294,273,21
"51","42101006700","Census Tract 67, Philadelphia County, Pennsylvania",7901,369,6830,10,272,0,103,317,39927,4666,1890,96,596,249,116,24,3,3238,2908,330,2908,1277,1631
"52","42101028500","Census Tract 285, Philadelphia County, Pennsylvania",2735,251,979,0,419,6,850,230,49167,1844,481,122,230,52,22,0,0,1174,1116,58,1116,616,500
"53","42101008500","Census Tract 85, Philadelphia County, Pennsylvania",6244,530,5277,161,110,0,22,144,41974,4558,1429,205,210,707,146,8,63,3601,3002,599,3002,1133,1869
"54","42101013500","Census Tract 135, Philadelphia County, Pennsylvania",4015,3221,593,0,164,0,6,31,133125,3053,267,27,38,1433,654,235,101,1824,1625,199,1625,1029,596
"55","42101989200","Census Tract 9892, Philadelphia County, Pennsylvania",0,0,0,0,0,0,0,0,NA,0,0,0,0,0,0,0,0,0,0,0,0,0,0
"56","42101038301","Census Tract 383.01, Philadelphia County, Pennsylvania",2395,532,960,0,0,0,665,238,NA,1799,731,56,193,94,26,0,0,883,701,182,701,326,375
"57","42101026200","Census Tract 262, Philadelphia County, Pennsylvania",3925,73,3769,0,28,0,55,0,62098,3193,955,85,322,548,327,95,0,1832,1689,143,1689,1418,271
"58","42101014600","Census Tract 146, Philadelphia County, Pennsylvania",4232,1343,1936,2,658,0,31,262,35600,1464,506,43,102,137,73,31,7,1268,1140,128,1140,452,688
"59","42101008301","Census Tract 83.01, Philadelphia County, Pennsylvania",4483,124,4049,5,0,0,13,292,35961,3093,914,117,321,449,39,0,1,1996,1627,369,1627,726,901
"60","42101015102","Census Tract 151.02, Philadelphia County, Pennsylvania",5061,31,4727,6,36,0,53,208,21427,3212,1153,273,95,102,105,27,13,2297,1813,484,1813,523,1290
"61","42101020101","Census Tract 201.01, Philadelphia County, Pennsylvania",3197,52,2923,12,107,0,0,103,22628,2397,1042,313,162,117,180,0,36,2227,1758,469,1758,470,1288
"62","42101006000","Census Tract 60, Philadelphia County, Pennsylvania",6239,451,4751,0,278,0,385,374,46987,4091,1575,189,304,458,228,61,0,2693,2400,293,2400,1426,974
"63","42101019800","Census Tract 198, Philadelphia County, Pennsylvania",6090,935,1325,0,345,0,2983,502,28971,3601,1113,259,290,273,81,0,58,2422,2130,292,2130,1322,808
"64","42101002801","Census Tract 28.01, Philadelphia County, Pennsylvania",4500,2393,42,18,1201,71,513,262,67021,3144,382,231,323,551,354,62,42,1791,1651,140,1651,767,884
"65","42101036902","Census Tract 369.02, Philadelphia County, Pennsylvania",5912,3448,878,11,1247,0,120,208,27821,820,70,9,13,317,155,36,99,1022,912,110,912,0,912
"66","42101007900","Census Tract 79, Philadelphia County, Pennsylvania",4321,2289,877,0,368,49,155,583,72847,3366,229,41,53,1091,733,202,392,2307,2204,103,2204,943,1261
"67","42101031600","Census Tract 316, Philadelphia County, Pennsylvania",6746,2979,1789,0,1281,0,450,247,61436,4621,1679,104,392,343,151,2,29,2261,2132,129,2132,1253,879
"68","42101024300","Census Tract 243, Philadelphia County, Pennsylvania",4470,542,3720,0,90,0,0,118,45154,3122,671,37,321,644,405,49,66,2049,1880,169,1880,915,965
"69","42101024900","Census Tract 249, Philadelphia County, Pennsylvania",2626,65,2492,0,0,0,0,69,26069,1612,440,138,136,184,46,0,0,1372,1075,297,1075,623,452
"70","42101036700","Census Tract 367, Philadelphia County, Pennsylvania",3405,2614,244,0,337,0,74,136,150952,2702,128,72,58,1220,603,217,145,1782,1576,206,1576,811,765
"71","42101002802","Census Tract 28.02, Philadelphia County, Pennsylvania",5535,3632,386,0,1148,0,119,250,71409,4309,551,92,96,1649,714,157,54,2505,2338,167,2338,1388,950
"72","42101004001","Census Tract 40.01, Philadelphia County, Pennsylvania",4111,2952,90,0,266,0,478,325,67841,3479,714,111,287,709,232,183,38,2124,1929,195,1929,1014,915
"73","42101000300","Census Tract 3, Philadelphia County, Pennsylvania",3566,2269,218,3,615,0,56,405,86782,2846,136,0,57,948,456,599,334,2336,2085,251,2085,426,1659
"74","42101016300","Census Tract 163, Philadelphia County, Pennsylvania",2761,476,337,0,33,0,1775,140,27625,1664,471,129,71,88,12,0,0,1192,936,256,936,340,596
"75","42101980600","Census Tract 9806, Philadelphia County, Pennsylvania",0,0,0,0,0,0,0,0,NA,0,0,0,0,0,0,0,0,0,0,0,0,0,0
"76","42101000901","Census Tract 9.01, Philadelphia County, Pennsylvania",2073,1452,273,0,262,0,39,47,49276,1788,61,21,70,728,415,234,112,1783,1571,212,1571,132,1439
"77","42101035701","Census Tract 357.01, Philadelphia County, Pennsylvania",4641,2682,211,0,1341,16,134,257,45571,3505,728,116,319,1223,185,16,44,1964,1885,79,1885,544,1341
"78","42101036100","Census Tract 361, Philadelphia County, Pennsylvania",4065,2556,1230,0,138,0,79,62,64688,2864,1179,105,350,305,129,22,0,1677,1536,141,1536,839,697
"79","42101036501","Census Tract 365.01, Philadelphia County, Pennsylvania",4833,3605,656,6,483,0,35,48,59402,3709,1106,208,222,745,306,41,62,2213,2168,45,2168,1104,1064
"80","42101029000","Census Tract 290, Philadelphia County, Pennsylvania",9054,1270,3373,0,1832,0,2426,153,43209,4939,1713,170,87,881,58,0,0,2247,2112,135,2112,1228,884
"81","42101024400","Census Tract 244, Philadelphia County, Pennsylvania",3482,220,2940,145,0,0,0,177,52826,2085,378,122,135,531,88,104,26,1307,1058,249,1058,610,448
"82","42101037600","Census Tract 376, Philadelphia County, Pennsylvania",3505,1685,735,0,763,0,120,202,94399,3130,468,88,96,1008,511,296,131,1868,1716,152,1716,477,1239
"83","42101003001","Census Tract 30.01, Philadelphia County, Pennsylvania",3419,1204,610,1,1239,0,121,244,49132,2934,687,52,206,954,173,71,21,1833,1544,289,1544,907,637
"84","42101002701","Census Tract 27.01, Philadelphia County, Pennsylvania",3899,2566,402,83,437,0,229,182,84055,3268,380,65,175,1123,536,147,29,2051,1877,174,1877,1116,761
"85","42101020701","Census Tract 207.01, Philadelphia County, Pennsylvania",4191,3488,203,0,102,0,66,332,109959,3470,245,20,115,1641,687,352,98,2009,1935,74,1935,1051,884
"86","42101036201","Census Tract 362.01, Philadelphia County, Pennsylvania",5306,4640,137,0,46,0,36,447,77788,4086,1271,88,389,833,266,10,20,2075,1985,90,1985,1338,647
"87","42101026500","Census Tract 265, Philadelphia County, Pennsylvania",5523,67,5250,0,0,0,46,160,42038,3066,1048,288,196,231,128,0,0,1821,1674,147,1674,1162,512
"88","42101030600","Census Tract 306, Philadelphia County, Pennsylvania",7058,2940,2443,0,453,0,873,349,58349,5081,1321,477,247,486,475,10,15,3043,2805,238,2805,1766,1039
"89","42101038000","Census Tract 380, Philadelphia County, Pennsylvania",2412,1696,198,0,57,0,378,83,45417,1491,691,71,24,264,10,0,0,889,762,127,762,477,285
"90","42101012203","Census Tract 122.03, Philadelphia County, Pennsylvania",863,209,176,0,300,87,0,91,63190,674,23,9,13,286,66,107,9,849,567,282,567,0,567
"91","42101000200","Census Tract 2, Philadelphia County, Pennsylvania",3414,1063,225,0,1888,0,3,235,91067,2714,329,26,189,1042,142,114,113,1739,1628,111,1628,875,753
"92","42101010200","Census Tract 102, Philadelphia County, Pennsylvania",3507,125,3333,0,0,0,0,49,28992,2217,812,28,78,171,222,0,0,1658,1363,295,1363,497,866
"93","42101014400","Census Tract 144, Philadelphia County, Pennsylvania",5090,3316,490,0,349,0,726,209,117904,4046,364,63,179,1579,519,300,210,2645,2446,199,2446,1373,1073
"94","42101013401","Census Tract 134.01, Philadelphia County, Pennsylvania",2925,2506,266,0,86,0,0,67,107823,2710,242,55,108,956,547,364,182,1915,1762,153,1762,1103,659
"95","42101012201","Census Tract 122.01, Philadelphia County, Pennsylvania",2828,716,1583,0,377,0,0,152,36646,2320,427,0,160,864,211,126,18,2372,2042,330,2042,0,2042
"96","42101021800","Census Tract 218, Philadelphia County, Pennsylvania",5198,3304,933,0,313,0,135,513,67663,3876,552,39,308,1204,611,162,80,2660,2541,119,2541,779,1762
"97","42101030502","Census Tract 305.02, Philadelphia County, Pennsylvania",7469,1491,3307,17,464,0,678,1512,55634,3761,1282,258,213,432,168,38,29,2002,1859,143,1859,1347,512
"98","42101014202","Census Tract 142.02, Philadelphia County, Pennsylvania",2355,1717,90,0,221,0,152,175,128098,2064,196,0,78,805,402,302,23,1489,1325,164,1325,425,900
"99","42101010700","Census Tract 107, Philadelphia County, Pennsylvania",3527,201,2975,297,0,0,18,36,36006,1948,583,211,51,214,59,0,36,1633,1184,449,1184,484,700
"100","42101031402","Census Tract 314.02, Philadelphia County, Pennsylvania",6426,1837,789,14,2038,0,1033,715,51546,3896,1034,157,95,305,123,18,18,1830,1769,61,1769,1033,736
"101","42101021100","Census Tract 211, Philadelphia County, Pennsylvania",2514,1789,249,0,122,0,215,139,64770,1783,266,32,57,666,339,34,135,1286,1286,0,1286,812,474
"102","42101035200","Census Tract 352, Philadelphia County, Pennsylvania",4934,4348,211,0,261,0,59,55,81367,3965,1631,112,277,668,309,145,0,2275,2194,81,2194,1920,274
"103","42101001201","Census Tract 12.01, Philadelphia County, Pennsylvania",4243,3396,179,12,244,0,25,387,106871,3218,141,11,18,1078,868,455,330,2296,2083,213,2083,913,1170
"104","42101033101","Census Tract 331.01, Philadelphia County, Pennsylvania",5458,3373,1044,0,284,0,420,337,61250,3125,1121,87,463,247,117,40,57,1845,1705,140,1705,1311,394
"105","42101027000","Census Tract 270, Philadelphia County, Pennsylvania",2623,274,2057,0,179,0,21,92,83750,1648,261,22,101,518,209,44,14,1038,980,58,980,635,345
"106","42101027901","Census Tract 279.01, Philadelphia County, Pennsylvania",3773,55,3438,0,20,0,32,228,35914,2497,759,22,156,375,175,0,66,1615,1463,152,1463,792,671
"107","42101020102","Census Tract 201.02, Philadelphia County, Pennsylvania",3756,67,3646,16,0,0,27,0,37431,2629,1087,134,177,328,51,0,0,1734,1611,123,1611,1047,564
"108","42101026900","Census Tract 269, Philadelphia County, Pennsylvania",2486,626,1742,0,52,0,7,59,75101,2003,450,93,141,511,151,23,37,798,735,63,735,481,254
"109","42101013100","Census Tract 131, Philadelphia County, Pennsylvania",1666,594,920,0,108,0,0,44,30709,1189,235,15,36,374,206,6,39,959,851,108,851,159,692
"110","42101000806","Census Tract 8.06, Philadelphia County, Pennsylvania",2227,1836,39,0,275,0,0,77,166885,2054,17,0,30,841,316,548,176,1878,1617,261,1617,445,1172
"111","42101021200","Census Tract 212, Philadelphia County, Pennsylvania",2666,2099,368,0,59,0,103,37,93114,2017,334,66,32,611,400,75,92,1264,1245,19,1245,854,391
"112","42101024200","Census Tract 242, Philadelphia County, Pennsylvania",4555,719,3686,0,55,0,0,95,28063,2928,656,152,386,481,271,14,25,2086,1901,185,1901,617,1284
"113","42101015600","Census Tract 156, Philadelphia County, Pennsylvania",1671,593,438,0,0,0,592,48,41103,1144,352,35,22,220,57,14,65,691,549,142,549,190,359
"114","42101010500","Census Tract 105, Philadelphia County, Pennsylvania",4112,298,3663,8,105,0,22,16,28472,2886,942,215,144,283,152,0,0,1742,1493,249,1493,558,935
"115","42101020800","Census Tract 208, Philadelphia County, Pennsylvania",2508,1363,673,0,243,0,37,192,74432,1809,146,51,41,544,471,172,113,1489,1343,146,1343,498,845
"116","42101017601","Census Tract 176.01, Philadelphia County, Pennsylvania",4643,1572,321,8,0,0,2742,0,23761,2867,692,131,62,133,26,0,0,2134,1792,342,1792,871,921
"117","42101014900","Census Tract 149, Philadelphia County, Pennsylvania",4349,359,3428,0,0,0,395,167,25897,2793,1003,112,108,256,279,61,0,2413,2012,401,2012,791,1221
"118","42101031900","Census Tract 319, Philadelphia County, Pennsylvania",5509,1950,2193,161,173,0,707,325,45290,3367,1026,134,380,292,64,104,1,1980,1826,154,1826,1077,749
"119","42101001800","Census Tract 18, Philadelphia County, Pennsylvania",3299,2503,490,0,163,0,0,143,99125,2523,169,70,101,760,726,281,133,1819,1691,128,1691,943,748
"120","42101003701","Census Tract 37.01, Philadelphia County, Pennsylvania",6013,1333,2743,82,1236,0,384,235,63075,4523,1471,333,538,825,287,16,39,2777,2315,462,2315,1572,743
"121","42101017400","Census Tract 174, Philadelphia County, Pennsylvania",2644,82,2243,0,13,0,113,193,30679,1815,608,187,112,58,8,0,0,1139,1024,115,1024,487,537
"122","42101003902","Census Tract 39.02, Philadelphia County, Pennsylvania",5569,5300,0,0,113,0,0,156,69265,4450,1704,220,195,1144,140,32,0,2588,2352,236,2352,1720,632
"123","42101024000","Census Tract 240, Philadelphia County, Pennsylvania",4060,1410,2073,10,164,0,60,343,55748,2920,736,44,201,484,732,121,0,2177,1999,178,1999,632,1367
"124","42101014800","Census Tract 148, Philadelphia County, Pennsylvania",862,37,607,0,166,0,12,40,16064,627,131,13,28,59,9,33,0,598,452,146,452,51,401
"125","42101031000","Census Tract 310, Philadelphia County, Pennsylvania",8135,3915,1665,270,1416,0,241,628,53347,4585,1091,130,360,596,265,0,27,2357,2169,188,2169,1317,852
"126","42101013800","Census Tract 138, Philadelphia County, Pennsylvania",1806,565,986,0,83,33,33,106,59800,1403,257,12,58,255,275,41,18,1166,930,236,930,395,535
"127","42101001203","Census Tract 12.03, Philadelphia County, Pennsylvania",1973,1808,39,0,80,0,30,16,94449,1662,52,23,39,801,372,172,102,1225,1225,0,1225,274,951
"128","42101024100","Census Tract 241, Philadelphia County, Pennsylvania",1419,242,1007,0,0,0,15,155,14928,1270,357,54,175,107,90,18,5,671,637,34,637,108,529
"129","42101034200","Census Tract 342, Philadelphia County, Pennsylvania",3706,2592,737,0,205,0,24,148,58854,2987,757,61,203,826,337,62,6,1859,1738,121,1738,736,1002
"130","42101000902","Census Tract 9.02, Philadelphia County, Pennsylvania",2795,1982,125,43,518,0,70,57,67014,2268,218,29,23,977,304,293,107,1518,1433,85,1433,230,1203
"131","42101038500","Census Tract 385, Philadelphia County, Pennsylvania",1819,1608,47,0,47,0,2,115,107375,1496,130,12,47,474,413,183,89,994,897,97,897,544,353
"132","42101035100","Census Tract 351, Philadelphia County, Pennsylvania",3856,3227,299,0,185,0,4,141,62188,3437,1056,239,191,786,488,91,43,2241,2045,196,2045,1355,690
"133","42101035601","Census Tract 356.01, Philadelphia County, Pennsylvania",5458,3732,251,0,839,0,591,45,53480,4370,1193,117,525,1152,305,67,0,2432,2312,120,2312,1573,739
"134","42101031200","Census Tract 312, Philadelphia County, Pennsylvania",5319,998,3479,0,204,0,536,102,50336,3910,1142,255,369,544,153,49,12,1895,1795,100,1795,833,962
"135","42101019000","Census Tract 190, Philadelphia County, Pennsylvania",7782,1824,1115,0,107,0,4124,612,39297,4330,1559,364,304,245,70,7,0,2511,2384,127,2384,1563,821
"136","42101027401","Census Tract 274.01, Philadelphia County, Pennsylvania",2746,142,1570,2,689,0,143,200,43438,1897,443,76,96,209,46,2,0,1187,1064,123,1064,480,584
"137","42101031502","Census Tract 315.02, Philadelphia County, Pennsylvania",3758,1376,539,0,1067,0,318,458,40000,2397,872,20,28,385,69,44,0,1414,1362,52,1362,769,593
"138","42101010000","Census Tract 100, Philadelphia County, Pennsylvania",5100,219,4601,0,98,0,13,169,46147,2962,558,175,198,405,219,0,12,2029,1740,289,1740,1015,725
"139","42101035500","Census Tract 355, Philadelphia County, Pennsylvania",7724,5790,364,0,1181,0,22,367,61579,5623,1401,303,241,951,1019,91,89,3172,3058,114,3058,2259,799
"140","42101038400","Census Tract 384, Philadelphia County, Pennsylvania",2407,1980,205,0,98,0,1,123,95455,1977,387,15,129,602,292,78,25,1048,1030,18,1030,829,201
"141","42101980001","Census Tract 9800.01, Philadelphia County, Pennsylvania",0,0,0,0,0,0,0,0,NA,0,0,0,0,0,0,0,0,0,0,0,0,0,0
"142","42101023900","Census Tract 239, Philadelphia County, Pennsylvania",1800,529,983,0,92,0,0,196,41917,1347,251,19,58,334,195,37,6,1311,1131,180,1131,148,983
"143","42101030800","Census Tract 308, Philadelphia County, Pennsylvania",5443,2378,1127,0,785,0,569,584,58449,3820,1136,248,337,679,191,29,7,2043,1843,200,1843,1393,450
"144","42101002300","Census Tract 23, Philadelphia County, Pennsylvania",2977,2093,21,0,642,0,121,100,85577,2348,272,49,47,676,288,185,91,1343,1234,109,1234,597,637
"145","42101010800","Census Tract 108, Philadelphia County, Pennsylvania",4396,286,3377,84,186,0,5,458,24706,2542,672,137,135,436,99,47,8,2179,1852,327,1852,544,1308
"146","42101033900","Census Tract 339, Philadelphia County, Pennsylvania",2962,1522,1000,0,222,0,62,156,52841,2219,708,131,67,472,238,24,53,1533,1444,89,1444,713,731
"147","42101980902","Census Tract 9809.02, Philadelphia County, Pennsylvania",0,0,0,0,0,0,0,0,NA,0,0,0,0,0,0,0,0,0,0,0,0,0,0
"148","42101033400","Census Tract 334, Philadelphia County, Pennsylvania",5676,2680,1222,0,1397,0,191,186,49748,3882,1435,150,261,643,284,41,95,2186,2107,79,2107,1210,897
"149","42101002100","Census Tract 21, Philadelphia County, Pennsylvania",2381,1014,1029,0,234,0,10,94,92955,1950,344,23,230,542,218,14,56,1134,948,186,948,606,342
"150","42101033701","Census Tract 337.01, Philadelphia County, Pennsylvania",7215,3709,1813,0,898,0,439,356,47109,4648,1509,360,249,782,264,184,37,2628,2504,124,2504,928,1576
"151","42101033200","Census Tract 332, Philadelphia County, Pennsylvania",3088,1640,148,0,1006,0,292,2,70750,2074,588,74,94,223,239,60,6,1129,1078,51,1078,836,242
"152","42101021300","Census Tract 213, Philadelphia County, Pennsylvania",3225,2646,358,0,53,0,21,147,79464,2717,413,47,175,829,517,126,126,1678,1576,102,1576,850,726
"153","42101000404","Census Tract 4.04, Philadelphia County, Pennsylvania",3260,2656,113,0,426,0,0,65,90504,3053,289,60,31,1178,829,184,174,2749,2323,426,2323,1017,1306
"154","42101028901","Census Tract 289.01, Philadelphia County, Pennsylvania",4445,1019,610,147,376,0,1983,310,35360,2490,1157,291,130,80,40,8,0,1362,1335,27,1335,848,487
"155","42101006100","Census Tract 61, Philadelphia County, Pennsylvania",2784,168,2437,0,161,0,0,18,37521,1900,558,61,183,199,65,0,0,1303,1193,110,1193,832,361
"156","42101019501","Census Tract 195.01, Philadelphia County, Pennsylvania",4942,1210,307,141,0,0,2853,431,20486,3130,710,288,352,169,43,0,11,2037,1817,220,1817,620,1197
"157","42101007400","Census Tract 74, Philadelphia County, Pennsylvania",4535,406,3255,0,114,0,23,737,43654,2925,1206,121,102,429,163,0,11,2195,1792,403,1792,809,983
"158","42101002000","Census Tract 20, Philadelphia County, Pennsylvania",2004,660,1014,7,162,0,35,126,71379,1709,306,38,124,420,368,101,25,1277,1082,195,1082,663,419
"159","42101000401","Census Tract 4.01, Philadelphia County, Pennsylvania",2573,1595,375,0,475,0,0,128,67188,2277,122,0,61,953,532,246,135,2183,1849,334,1849,628,1221
"160","42101016800","Census Tract 168, Philadelphia County, Pennsylvania",3440,254,2956,0,21,0,129,80,14798,2270,730,142,241,52,113,0,15,1844,1508,336,1508,748,760
"161","42101024600","Census Tract 246, Philadelphia County, Pennsylvania",2647,160,2318,72,27,0,9,61,29468,1702,488,195,25,108,165,0,0,1354,1028,326,1028,303,725
"162","42101009801","Census Tract 98.01, Philadelphia County, Pennsylvania",2455,192,2175,0,41,0,0,47,68165,1672,353,137,70,257,113,10,14,1109,1051,58,1051,640,411
"163","42101021900","Census Tract 219, Philadelphia County, Pennsylvania",1437,1240,100,0,7,0,20,70,67083,1059,217,13,87,252,191,7,38,716,645,71,645,566,79
"164","42101029300","Census Tract 293, Philadelphia County, Pennsylvania",3048,1320,428,0,0,0,1108,192,NA,2006,494,206,97,169,195,0,0,1312,1187,125,1187,586,601
"165","42101017201","Census Tract 172.01, Philadelphia County, Pennsylvania",3031,126,2905,0,0,0,0,0,NA,2430,815,57,141,41,105,0,0,1701,1484,217,1484,1010,474
"166","42101021700","Census Tract 217, Philadelphia County, Pennsylvania",6134,4573,1036,0,34,0,37,454,88998,4815,1032,153,531,1321,600,165,10,2687,2641,46,2641,2118,523
"167","42101018801","Census Tract 188.01, Philadelphia County, Pennsylvania",3504,1038,280,0,0,0,1581,605,20120,2128,841,207,158,55,0,0,0,1478,1233,245,1233,579,654
"168","42101980903","Census Tract 9809.03, Philadelphia County, Pennsylvania",0,0,0,0,0,0,0,0,NA,0,0,0,0,0,0,0,0,0,0,0,0,0,0
"169","42101008302","Census Tract 83.02, Philadelphia County, Pennsylvania",4561,14,4420,53,0,0,0,74,25151,3106,1310,169,159,211,91,0,49,2181,1864,317,1864,795,1069
"170","42101016701","Census Tract 167.01, Philadelphia County, Pennsylvania",3579,149,3349,0,0,0,27,54,35425,2181,691,81,317,272,16,0,0,1867,1526,341,1526,893,633
"171","42101028100","Census Tract 281, Philadelphia County, Pennsylvania",4317,388,3619,0,0,0,208,102,46378,3239,1279,30,132,253,242,0,0,1962,1917,45,1917,1349,568
"172","42101034502","Census Tract 345.02, Philadelphia County, Pennsylvania",5644,2703,1445,0,1196,0,0,300,49636,3882,1001,143,179,806,602,83,14,2469,2371,98,2371,960,1411
"173","42101026800","Census Tract 268, Philadelphia County, Pennsylvania",4614,450,3611,31,74,0,129,319,41220,3521,1225,128,397,489,257,8,57,2279,2014,265,2014,606,1408
"174","42101007101","Census Tract 71.01, Philadelphia County, Pennsylvania",2642,147,2352,0,34,0,23,86,34552,1546,554,49,132,27,45,0,0,1099,809,290,809,345,464
"175","42101034803","Census Tract 348.03, Philadelphia County, Pennsylvania",3859,3208,76,12,78,0,323,162,85070,2987,1064,143,248,503,209,173,0,1748,1642,106,1642,1363,279
"176","42101009600","Census Tract 96, Philadelphia County, Pennsylvania",3775,0,3579,0,2,50,136,8,45984,2345,726,49,92,207,148,0,0,2226,1553,673,1553,831,722
"177","42101000801","Census Tract 8.01, Philadelphia County, Pennsylvania",1670,1244,29,0,170,0,0,227,126905,1256,24,0,21,497,264,272,135,1095,952,143,952,286,666
"178","42101012100","Census Tract 121, Philadelphia County, Pennsylvania",3219,642,2320,0,94,0,32,131,47875,2606,460,71,114,502,527,113,37,1717,1623,94,1623,487,1136
"179","42101030900","Census Tract 309, Philadelphia County, Pennsylvania",4425,1490,1943,0,284,0,244,464,46980,2720,969,260,273,347,41,60,0,1564,1498,66,1498,754,744
"180","42101021400","Census Tract 214, Philadelphia County, Pennsylvania",3748,3320,251,0,10,0,0,167,77686,2966,165,120,112,1444,456,143,193,2227,1935,292,1935,669,1266
"181","42101013702","Census Tract 137.02, Philadelphia County, Pennsylvania",4063,1423,2442,0,81,0,0,117,50185,2851,696,35,21,715,464,95,51,2055,1790,265,1790,806,984
"182","42101035301","Census Tract 353.01, Philadelphia County, Pennsylvania",5419,4517,108,19,106,0,101,568,80980,3867,1262,153,513,621,130,19,38,2194,2105,89,2105,1496,609
"183","42101008400","Census Tract 84, Philadelphia County, Pennsylvania",5074,77,4281,0,181,0,46,489,49417,3073,877,35,183,262,212,16,10,1967,1720,247,1720,1028,692
"184","42101034000","Census Tract 340, Philadelphia County, Pennsylvania",2970,2543,125,35,185,0,68,14,94545,2297,762,119,118,455,146,34,55,1213,1202,11,1202,1050,152
"185","42101029100","Census Tract 291, Philadelphia County, Pennsylvania",4287,723,1426,0,915,0,1122,101,24000,2945,573,70,52,472,40,0,0,1803,1704,99,1704,531,1173
"186","42101007200","Census Tract 72, Philadelphia County, Pennsylvania",4486,121,3682,0,37,0,96,550,38704,2530,967,43,77,395,148,13,0,1943,1618,325,1618,743,875
"187","42101038100","Census Tract 381, Philadelphia County, Pennsylvania",887,477,170,0,3,0,73,164,32773,651,286,26,6,53,16,0,0,372,348,24,348,146,202
"188","42101027100","Census Tract 271, Philadelphia County, Pennsylvania",2530,260,1780,0,344,0,37,109,54725,1905,491,96,236,258,66,0,104,1049,1014,35,1014,761,253
"189","42101031101","Census Tract 311.01, Philadelphia County, Pennsylvania",4748,993,1713,0,724,0,871,447,42842,2938,1207,132,124,430,100,0,0,1939,1788,151,1788,876,912
"190","42101005500","Census Tract 55, Philadelphia County, Pennsylvania",6525,687,5171,12,103,0,89,463,65706,4706,1389,275,413,1111,207,102,0,2883,2798,85,2798,1708,1090
"191","42101027402","Census Tract 274.02, Philadelphia County, Pennsylvania",7408,1116,4344,0,442,0,1156,350,61895,4347,1286,62,151,319,17,36,30,2499,2453,46,2453,2081,372
"192","42101004002","Census Tract 40.02, Philadelphia County, Pennsylvania",5199,4058,215,0,586,0,0,340,68523,3698,1452,196,125,534,282,156,26,2448,2269,179,2269,1671,598
"193","42101032300","Census Tract 323, Philadelphia County, Pennsylvania",3652,1579,1300,0,0,0,285,488,32859,2128,810,95,206,138,60,13,0,1674,1505,169,1505,828,677
"194","42101015800","Census Tract 158, Philadelphia County, Pennsylvania",7248,5900,386,0,271,0,95,596,101365,5731,655,119,177,2138,1186,181,197,3312,3295,17,3295,1943,1352
"195","42101028200","Census Tract 282, Philadelphia County, Pennsylvania",4840,95,4209,0,352,0,41,143,30611,3619,1528,42,174,391,77,0,0,2351,2216,135,2216,1113,1103
"196","42101030700","Census Tract 307, Philadelphia County, Pennsylvania",4596,1474,1964,50,182,0,313,613,50742,3091,720,66,303,597,313,21,26,2005,1885,120,1885,594,1291
"197","42101009400","Census Tract 94, Philadelphia County, Pennsylvania",3895,85,3562,0,0,0,27,221,22438,2465,829,161,144,117,23,0,5,2126,1803,323,1803,571,1232
"198","42101000702","Census Tract 7.02, Philadelphia County, Pennsylvania",2181,1106,110,18,683,0,156,108,54121,2077,111,0,62,776,604,119,161,1677,1511,166,1511,294,1217
"199","42101008702","Census Tract 87.02, Philadelphia County, Pennsylvania",2896,1606,425,0,538,0,192,135,33902,1897,181,65,6,580,406,126,320,1868,1589,279,1589,144,1445
"200","42101032600","Census Tract 326, Philadelphia County, Pennsylvania",7991,4541,989,0,1189,0,891,381,64488,5142,1806,375,419,497,420,41,35,3021,2919,102,2919,2260,659
"201","42101013402","Census Tract 134.02, Philadelphia County, Pennsylvania",2985,2301,229,16,93,0,183,163,82434,2295,118,0,103,989,498,370,74,2011,1851,160,1851,502,1349
"202","42101031300","Census Tract 313, Philadelphia County, Pennsylvania",7700,2679,1836,0,1383,0,1105,697,53735,4890,2290,21,341,247,3,0,18,2490,2398,92,2398,957,1441
"203","42101003901","Census Tract 39.01, Philadelphia County, Pennsylvania",6400,4772,375,0,976,0,78,199,55876,5201,1147,185,476,1332,500,66,46,3285,3036,249,3036,1359,1677
"204","42101010300","Census Tract 103, Philadelphia County, Pennsylvania",2757,35,2695,0,0,0,27,0,30680,1772,961,35,124,92,23,0,0,1305,980,325,980,356,624
"205","42101014000","Census Tract 140, Philadelphia County, Pennsylvania",4751,1449,2652,0,200,0,213,237,59432,3023,663,29,235,789,397,194,37,2225,1949,276,1949,427,1522
"206","42101001600","Census Tract 16, Philadelphia County, Pennsylvania",2349,2046,122,0,113,0,24,44,147782,1913,102,0,88,839,363,285,94,1377,1195,182,1195,584,611
"207","42101030501","Census Tract 305.01, Philadelphia County, Pennsylvania",5104,436,3266,12,273,0,758,359,39863,2984,1130,192,250,190,62,35,0,1903,1762,141,1762,1000,762
"208","42101011000","Census Tract 110, Philadelphia County, Pennsylvania",2950,394,2328,0,13,0,148,67,15870,1674,532,170,72,147,24,0,18,1863,1388,475,1388,512,876
"209","42101026301","Census Tract 263.01, Philadelphia County, Pennsylvania",3676,82,3424,0,0,0,32,138,49732,2691,830,12,197,406,241,5,98,1691,1534,157,1534,1313,221
"210","42101001302","Census Tract 13.02, Philadelphia County, Pennsylvania",5086,3668,1015,0,243,0,56,104,109458,3559,322,80,65,991,851,577,512,2304,2066,238,2066,1168,898
"211","42101004104","Census Tract 41.04, Philadelphia County, Pennsylvania",4143,1607,0,0,2054,0,94,388,54597,2959,945,240,178,627,141,0,5,1383,1352,31,1352,735,617
"212","42101014100","Census Tract 141, Philadelphia County, Pennsylvania",2781,579,1770,26,302,0,45,59,18736,2006,530,41,39,375,124,30,44,1271,1221,50,1221,255,966
"213","42101038800","Census Tract 388, Philadelphia County, Pennsylvania",3783,2336,938,0,65,0,0,444,84632,2818,224,129,70,803,696,319,169,1924,1643,281,1643,1012,631
"214","42101036600","Census Tract 366, Philadelphia County, Pennsylvania",2337,1723,153,25,350,0,0,86,144659,1972,87,0,139,903,298,191,92,1434,1205,229,1205,570,635
"215","42101012501","Census Tract 125.01, Philadelphia County, Pennsylvania",1932,1235,264,0,342,0,0,91,68138,1688,313,0,54,453,428,265,32,1418,1096,322,1096,0,1096
"216","42101012204","Census Tract 122.04, Philadelphia County, Pennsylvania",3845,550,2970,22,162,0,55,86,58548,3211,563,3,133,773,638,91,57,2063,1867,196,1867,919,948
"217","42101012502","Census Tract 125.02, Philadelphia County, Pennsylvania",3697,2520,300,0,719,0,46,112,81262,3237,354,0,57,943,852,476,283,2854,2630,224,2630,438,2192
"218","42101000101","Census Tract 1.01, Philadelphia County, Pennsylvania",2004,1683,28,0,157,0,99,37,104052,1759,52,0,0,811,510,250,110,1450,1350,100,1350,366,984
"219","42101028000","Census Tract 280, Philadelphia County, Pennsylvania",4294,44,4149,0,0,0,1,100,31797,2955,606,127,219,208,112,2,0,2005,1735,270,1735,1107,628
"220","42101017701","Census Tract 177.01, Philadelphia County, Pennsylvania",3420,502,956,0,62,0,1845,55,23491,2107,670,78,179,136,16,17,0,1440,1210,230,1210,440,770
"221","42101980100","Census Tract 9801, Philadelphia County, Pennsylvania",296,288,0,1,0,0,0,7,96181,128,0,0,54,0,62,4,8,65,65,0,65,58,7
"222","42101980200","Census Tract 9802, Philadelphia County, Pennsylvania",392,261,103,0,2,0,6,20,NA,364,194,7,0,47,23,9,0,17,17,0,17,17,0
"223","42101037700","Census Tract 377, Philadelphia County, Pennsylvania",5065,2005,1980,0,235,0,517,328,19437,1755,873,0,46,204,10,0,22,1758,1467,291,1467,242,1225
"224","42101028600","Census Tract 286, Philadelphia County, Pennsylvania",7281,462,4280,0,277,0,2125,137,53005,4663,1457,743,216,257,90,123,0,2749,2605,144,2605,1481,1124
"225","42101033800","Census Tract 338, Philadelphia County, Pennsylvania",6903,4868,958,26,186,0,659,206,64940,5235,2020,52,453,834,137,52,91,2643,2643,0,2643,1492,1151
"226","42101039100","Census Tract 391, Philadelphia County, Pennsylvania",3536,17,3437,0,23,0,0,59,30077,1891,860,136,60,119,25,0,0,1195,1161,34,1161,181,980
"227","42101003200","Census Tract 32, Philadelphia County, Pennsylvania",3946,784,2382,9,212,0,176,383,46500,2813,946,47,266,598,126,41,10,2089,1632,457,1632,980,652
"228","42101024500","Census Tract 245, Philadelphia County, Pennsylvania",4367,148,4121,0,35,0,0,63,18253,2405,746,62,67,407,104,0,13,1874,1657,217,1657,703,954
"229","42101008200","Census Tract 82, Philadelphia County, Pennsylvania",6911,278,6555,0,0,0,20,58,31805,4652,2031,95,359,570,360,0,85,3395,2998,397,2998,2033,965
"230","42101020500","Census Tract 205, Philadelphia County, Pennsylvania",3160,127,2804,0,127,0,20,82,NA,2591,1182,72,119,48,47,59,7,1802,1706,96,1706,584,1122
"231","42101007700","Census Tract 77, Philadelphia County, Pennsylvania",1991,1100,363,0,276,0,58,194,46667,998,81,40,42,411,174,27,91,823,728,95,728,94,634
"232","42101005600","Census Tract 56, Philadelphia County, Pennsylvania",1171,61,1019,0,2,0,17,72,42661,838,424,15,38,32,36,0,45,727,662,65,662,67,595
"233","42101008701","Census Tract 87.01, Philadelphia County, Pennsylvania",3178,1648,388,50,853,0,37,202,47566,2313,105,0,105,482,777,50,443,2058,1773,285,1773,267,1506
"234","42101016001","Census Tract 160.01, Philadelphia County, Pennsylvania",2410,2118,266,0,0,0,0,26,85380,1753,287,36,86,646,258,41,54,1257,1129,128,1129,851,278
"235","42101019200","Census Tract 192, Philadelphia County, Pennsylvania",8667,1311,1771,32,651,0,4516,386,21638,4161,1639,218,396,134,23,0,0,2923,2455,468,2455,1188,1267
"236","42101037500","Census Tract 375, Philadelphia County, Pennsylvania",3449,1326,1579,0,320,0,32,192,75000,2382,266,133,279,463,469,204,114,1515,1352,163,1352,811,541
"237","42101980906","Census Tract 9809.06, Philadelphia County, Pennsylvania",0,0,0,0,0,0,0,0,NA,0,0,0,0,0,0,0,0,0,0,0,0,0,0
"238","42101002200","Census Tract 22, Philadelphia County, Pennsylvania",2482,1073,1171,0,92,0,113,33,65598,1926,240,78,50,496,289,104,61,1430,1157,273,1157,518,639
"239","42101035900","Census Tract 359, Philadelphia County, Pennsylvania",5159,3609,43,0,1201,0,220,86,58772,4064,1354,143,326,977,204,74,118,2337,2159,178,2159,1457,702
"240","42101002900","Census Tract 29, Philadelphia County, Pennsylvania",4096,3060,127,0,357,0,37,515,76394,3419,476,26,95,1164,682,196,97,2319,2229,90,2229,1412,817
"241","42101017500","Census Tract 175, Philadelphia County, Pennsylvania",6663,1820,1903,0,0,0,2934,6,23255,4616,1515,194,174,70,0,0,0,3007,2635,372,2635,1358,1277
"242","42101001301","Census Tract 13.01, Philadelphia County, Pennsylvania",1924,963,552,0,171,0,13,225,174327,1421,57,0,165,570,433,67,89,859,795,64,795,523,272
"243","42101023100","Census Tract 231, Philadelphia County, Pennsylvania",1293,1179,23,0,40,0,30,21,129571,943,48,28,7,326,159,133,127,579,522,57,522,339,183
"244","42101011300","Census Tract 113, Philadelphia County, Pennsylvania",3533,78,3455,0,0,0,0,0,40326,2240,617,56,135,364,170,0,0,1490,1272,218,1272,896,376
"245","42101027902","Census Tract 279.02, Philadelphia County, Pennsylvania",4762,1469,2732,0,217,0,50,294,33702,1583,602,56,154,119,117,4,15,1198,1089,109,1089,391,698
"246","42101036901","Census Tract 369.01, Philadelphia County, Pennsylvania",0,0,0,0,0,0,0,0,NA,0,0,0,0,0,0,0,0,0,0,0,0,0,0
"247","42101003100","Census Tract 31, Philadelphia County, Pennsylvania",5227,1449,3031,58,88,0,440,161,71054,3657,851,117,213,784,401,194,85,2531,2296,235,2296,1379,917
"248","42101004103","Census Tract 41.03, Philadelphia County, Pennsylvania",4751,1137,191,0,1391,0,1747,285,42675,2738,971,4,116,282,100,42,0,1449,1351,98,1351,711,640
"249","42101008101","Census Tract 81.01, Philadelphia County, Pennsylvania",3320,294,3026,0,0,0,0,0,44261,1973,543,11,166,219,72,0,0,1283,1075,208,1075,568,507
"250","42101021500","Census Tract 215, Philadelphia County, Pennsylvania",3958,2894,679,15,161,0,108,101,94735,3257,367,5,119,1369,526,191,27,2065,1985,80,1985,1137,848
"251","42101015300","Census Tract 153, Philadelphia County, Pennsylvania",4242,1635,2009,0,468,0,84,46,25871,1438,558,24,34,131,91,0,0,1772,1289,483,1289,307,982
"252","42101028400","Census Tract 284, Philadelphia County, Pennsylvania",3751,322,2997,0,334,0,15,83,21670,2377,950,212,126,42,15,0,0,1479,1363,116,1363,751,612
"253","42101011800","Census Tract 118, Philadelphia County, Pennsylvania",5588,112,5306,0,62,0,10,98,38642,3920,1042,0,208,673,613,28,33,2488,2151,337,2151,1894,257
"254","42101013900","Census Tract 139, Philadelphia County, Pennsylvania",2903,1215,1335,15,12,0,179,147,45175,2267,345,29,35,508,325,30,15,1554,1317,237,1317,358,959
"255","42101031800","Census Tract 318, Philadelphia County, Pennsylvania",4299,1249,1846,0,176,0,367,661,57094,2815,715,207,220,448,63,50,18,1954,1855,99,1855,1208,647
"256","42101035302","Census Tract 353.02, Philadelphia County, Pennsylvania",4600,3382,354,42,226,0,69,527,58750,3091,1202,105,168,554,162,25,10,1849,1721,128,1721,1123,598
"257","42101013701","Census Tract 137.01, Philadelphia County, Pennsylvania",1557,989,373,0,117,0,21,57,84189,1370,112,38,30,658,304,47,0,1064,972,92,972,360,612
"258","42101017300","Census Tract 173, Philadelphia County, Pennsylvania",2764,198,2263,43,1,0,239,20,31935,1565,464,59,73,223,116,0,0,1297,1146,151,1146,449,697
"259","42101000102","Census Tract 1.02, Philadelphia County, Pennsylvania",2752,2511,82,0,76,0,48,35,91944,2367,62,0,20,1067,531,422,90,2057,1840,217,1840,658,1182
"260","42101017900","Census Tract 179, Philadelphia County, Pennsylvania",5742,2131,1059,0,140,0,1801,611,44468,3811,1240,209,477,254,399,43,30,2779,2450,329,2450,1354,1096
"261","42101004101","Census Tract 41.01, Philadelphia County, Pennsylvania",5029,2071,535,0,1888,0,294,241,60925,3668,809,18,215,640,380,78,0,2335,1964,371,1964,1256,708
"262","42101025800","Census Tract 258, Philadelphia County, Pennsylvania",1745,67,1388,25,19,0,0,246,44250,1377,401,13,140,174,117,25,6,923,864,59,864,739,125
"263","42101007300","Census Tract 73, Philadelphia County, Pennsylvania",3173,570,2364,0,116,0,48,75,45446,2170,519,52,128,606,177,21,20,1502,1309,193,1309,661,648
"264","42101008602","Census Tract 86.02, Philadelphia County, Pennsylvania",3096,799,1955,0,242,0,4,96,30822,2217,528,126,298,324,327,0,22,1764,1543,221,1543,204,1339
"265","42101980901","Census Tract 9809.01, Philadelphia County, Pennsylvania",0,0,0,0,0,0,0,0,NA,0,0,0,0,0,0,0,0,0,0,0,0,0,0
"266","42101034701","Census Tract 347.01, Philadelphia County, Pennsylvania",7156,4328,1336,0,1206,0,108,178,63326,5408,1825,180,350,961,373,142,74,2855,2855,0,2855,1943,912
"267","42101028902","Census Tract 289.02, Philadelphia County, Pennsylvania",6748,1845,2199,157,757,0,1512,278,33671,3659,1066,202,337,505,30,25,27,2193,2087,106,2087,1448,639
"268","42101980003","Census Tract 9800.03, Philadelphia County, Pennsylvania",0,0,0,0,0,0,0,0,NA,0,0,0,0,0,0,0,0,0,0,0,0,0,0
"269","42101009802","Census Tract 98.02, Philadelphia County, Pennsylvania",5713,380,5184,0,0,0,0,149,66830,3701,1059,126,317,605,404,57,18,2319,2107,212,2107,1614,493
"270","42101034501","Census Tract 345.01, Philadelphia County, Pennsylvania",5056,2812,1067,0,696,0,212,269,53173,3626,917,322,260,653,565,57,89,2441,2393,48,2393,331,2062
"271","42101023700","Census Tract 237, Philadelphia County, Pennsylvania",4790,1633,2877,0,44,0,37,199,75583,3558,472,81,161,961,948,280,85,2531,2266,265,2266,974,1292
"272","42101035602","Census Tract 356.02, Philadelphia County, Pennsylvania",3686,2389,237,0,932,5,71,52,94508,2664,873,143,222,539,186,67,73,1282,1274,8,1274,1064,210
"273","42101035800","Census Tract 358, Philadelphia County, Pennsylvania",6464,4357,195,35,1357,0,279,241,59764,4741,1715,103,423,1044,580,172,71,2341,2305,36,2305,1659,646
"274","42101018001","Census Tract 180.01, Philadelphia County, Pennsylvania",2296,1911,31,0,0,0,50,304,50549,1676,620,92,58,367,110,0,7,1140,1062,78,1062,682,380
"275","42101018400","Census Tract 184, Philadelphia County, Pennsylvania",2304,2176,1,0,17,0,0,110,60607,1496,632,165,127,143,113,65,0,931,861,70,861,769,92
"276","42101023800","Census Tract 238, Philadelphia County, Pennsylvania",4993,1227,3246,0,44,0,51,425,79647,3506,561,203,363,836,676,197,31,2397,2019,378,2019,896,1123
"277","42101016002","Census Tract 160.02, Philadelphia County, Pennsylvania",4520,3840,104,0,272,0,69,235,83178,3730,698,38,290,1239,429,147,86,2301,2130,171,2130,1423,707
"278","42101002400","Census Tract 24, Philadelphia County, Pennsylvania",4860,3720,304,129,487,0,0,220,91382,3930,464,53,74,1464,826,246,247,2850,2583,267,2583,1373,1210
"279","42101011400","Census Tract 114, Philadelphia County, Pennsylvania",6426,295,6017,0,15,0,26,73,37530,4196,1286,329,105,474,438,89,80,3510,3132,378,3132,1548,1584
"280","42101036202","Census Tract 362.02, Philadelphia County, Pennsylvania",6099,4957,335,0,497,0,286,24,82262,4373,1466,113,186,891,419,21,21,2467,2388,79,2388,1888,500
"281","42101025200","Census Tract 252, Philadelphia County, Pennsylvania",7870,659,6851,97,30,0,84,149,25080,5471,1052,322,552,600,430,35,16,3734,3400,334,3400,1288,2112
"282","42101016702","Census Tract 167.02, Philadelphia County, Pennsylvania",2439,266,2173,0,0,0,0,0,31385,1682,715,95,59,127,0,37,0,1246,882,364,882,367,515
"283","42101027800","Census Tract 278, Philadelphia County, Pennsylvania",4858,119,4638,0,35,0,18,48,43555,3296,1429,256,145,136,167,0,73,2198,1975,223,1975,852,1123
"284","42101025600","Census Tract 256, Philadelphia County, Pennsylvania",2868,1666,853,0,91,0,110,148,92404,2256,408,53,171,459,442,116,184,1248,1186,62,1186,795,391
"285","42101006300","Census Tract 63, Philadelphia County, Pennsylvania",4069,155,3286,0,289,0,73,266,29307,2740,850,279,198,106,83,0,8,1936,1523,413,1523,478,1045
"286","42101009200","Census Tract 92, Philadelphia County, Pennsylvania",3489,699,2086,72,438,0,54,140,40234,2143,345,123,48,526,309,99,54,1741,1487,254,1487,555,932
"287","42101026400","Census Tract 264, Philadelphia County, Pennsylvania",5564,63,5501,0,0,0,0,0,57654,4443,1088,224,406,441,232,83,0,2400,2246,154,2246,1568,678
"288","42101011200","Census Tract 112, Philadelphia County, Pennsylvania",6443,201,6007,0,0,0,38,197,26220,3212,1123,192,91,321,47,13,33,2485,2015,470,2015,1141,874
"289","42101989300","Census Tract 9893, Philadelphia County, Pennsylvania",112,39,63,0,10,0,0,0,NA,104,11,20,0,0,0,0,0,0,0,0,0,0,0
"290","42101025500","Census Tract 255, Philadelphia County, Pennsylvania",2813,1084,1441,0,63,0,42,183,68958,2127,208,30,100,542,526,154,135,1251,1160,91,1160,873,287
"291","42101001900","Census Tract 19, Philadelphia County, Pennsylvania",4044,2345,978,0,502,0,25,194,138093,3270,202,16,110,1214,711,543,199,1838,1732,106,1732,1021,711
"292","42101038700","Census Tract 387, Philadelphia County, Pennsylvania",2593,2012,332,0,161,0,5,83,118750,1734,208,6,38,467,437,270,106,892,829,63,829,604,225
"293","42101031401","Census Tract 314.01, Philadelphia County, Pennsylvania",7969,2982,1254,51,1264,0,1638,780,50810,4366,1442,246,269,87,63,30,0,2228,2069,159,2069,835,1234
"294","42101020400","Census Tract 204, Philadelphia County, Pennsylvania",3453,72,3013,0,0,0,203,165,31350,2253,1301,123,0,41,37,83,0,1393,1153,240,1153,838,315
"295","42101036502","Census Tract 365.02, Philadelphia County, Pennsylvania",4237,3773,5,0,116,0,94,249,86615,3143,1012,52,309,691,327,65,46,1790,1725,65,1725,1286,439
"296","42101027600","Census Tract 276, Philadelphia County, Pennsylvania",4253,30,3791,0,108,0,0,324,41957,2977,823,130,355,242,302,36,11,2063,1832,231,1832,941,891
"297","42101017602","Census Tract 176.02, Philadelphia County, Pennsylvania",4148,612,640,0,303,0,2498,95,33125,2300,635,61,107,74,0,0,0,1393,1268,125,1268,503,765
"298","42101015700","Census Tract 157, Philadelphia County, Pennsylvania",2382,1598,105,7,149,0,267,256,75521,1848,325,38,45,661,188,128,0,1369,1148,221,1148,791,357
"299","42101031700","Census Tract 317, Philadelphia County, Pennsylvania",5860,2007,937,0,611,0,1865,440,29115,4156,1715,293,224,248,229,23,0,2658,2406,252,2406,1828,578
"300","42101015101","Census Tract 151.01, Philadelphia County, Pennsylvania",2017,104,1870,0,10,0,3,30,30888,1025,375,29,67,94,124,0,0,1033,765,268,765,275,490
"301","42101001101","Census Tract 11.01, Philadelphia County, Pennsylvania",4217,2677,608,0,330,0,72,530,48370,2944,217,49,181,996,559,288,114,2541,2404,137,2404,554,1850
"302","42101003002","Census Tract 30.02, Philadelphia County, Pennsylvania",3124,1186,1140,0,344,0,226,228,66217,2369,568,80,74,492,255,54,176,1762,1493,269,1493,781,712
"303","42101007000","Census Tract 70, Philadelphia County, Pennsylvania",3620,29,3448,0,0,22,15,106,34928,2314,823,181,57,162,70,0,30,1732,1467,265,1467,741,726
"304","42101017000","Census Tract 170, Philadelphia County, Pennsylvania",3438,601,2476,20,50,0,119,172,54232,2577,629,84,102,537,464,35,53,1703,1467,236,1467,309,1158
"305","42101036301","Census Tract 363.01, Philadelphia County, Pennsylvania",4149,2950,56,11,920,0,127,85,77115,3004,1113,90,228,624,111,8,0,1549,1474,75,1474,1129,345
"306","42101037300","Census Tract 373, Philadelphia County, Pennsylvania",5918,5051,622,0,245,0,0,0,88348,4233,1351,34,164,1308,507,164,15,2861,2779,82,2779,1605,1174
"307","42101008000","Census Tract 80, Philadelphia County, Pennsylvania",4045,938,2786,0,42,0,46,233,58355,2994,533,16,102,968,460,49,16,1976,1745,231,1745,866,879
"308","42101032500","Census Tract 325, Philadelphia County, Pennsylvania",6100,2954,1228,0,739,0,668,511,45163,4007,1118,206,345,169,99,0,0,2794,2416,378,2416,1212,1204
"309","42101019900","Census Tract 199, Philadelphia County, Pennsylvania",5398,711,2384,0,0,0,2024,279,25211,3541,1199,96,121,178,45,0,0,1993,1811,182,1811,563,1248
"310","42101980701","Census Tract 9807.01, Philadelphia County, Pennsylvania",0,0,0,0,0,0,0,0,NA,0,0,0,0,0,0,0,0,0,0,0,0,0,0
"311","42101006500","Census Tract 65, Philadelphia County, Pennsylvania",4270,122,3899,0,0,10,177,62,39141,2662,925,131,223,201,232,13,0,2181,1640,541,1640,854,786
"312","42101033600","Census Tract 336, Philadelphia County, Pennsylvania",6425,4266,505,0,1357,0,234,63,46061,4769,1370,190,251,884,380,71,0,2763,2524,239,2524,1214,1310
"313","42101007102","Census Tract 71.02, Philadelphia County, Pennsylvania",4436,246,4030,31,0,0,107,22,29321,3129,1360,165,112,244,161,58,0,2060,1719,341,1719,946,773
"314","42101009000","Census Tract 90, Philadelphia County, Pennsylvania",6502,4192,954,1,1139,0,75,141,33750,1179,149,69,22,342,151,91,111,1421,1202,219,1202,97,1105
"315","42101980800","Census Tract 9808, Philadelphia County, Pennsylvania",0,0,0,0,0,0,0,0,NA,0,0,0,0,0,0,0,0,0,0,0,0,0,0
"316","42101038900","Census Tract 389, Philadelphia County, Pennsylvania",3618,253,3020,130,0,0,57,158,46250,2659,619,255,234,330,279,22,38,1328,1305,23,1305,750,555
"317","42101029200","Census Tract 292, Philadelphia County, Pennsylvania",4321,859,1564,21,333,0,1144,400,62793,2751,960,125,164,398,117,0,0,1545,1399,146,1399,1215,184
"318","42101034100","Census Tract 341, Philadelphia County, Pennsylvania",5606,4033,336,0,589,0,492,156,63998,4280,1575,120,303,630,472,118,109,2750,2657,93,2657,1432,1225
"319","42101035702","Census Tract 357.02, Philadelphia County, Pennsylvania",4255,3682,18,0,370,0,0,185,48333,3080,852,131,276,798,194,105,39,1953,1776,177,1776,648,1128
"320","42101000803","Census Tract 8.03, Philadelphia County, Pennsylvania",2916,2411,105,0,266,0,28,106,82121,2491,13,0,46,1032,553,411,277,2274,1883,391,1883,781,1102
"321","42101003702","Census Tract 37.02, Philadelphia County, Pennsylvania",3871,919,1624,35,1075,0,26,192,44917,2338,534,101,80,547,77,33,64,1394,1277,117,1277,635,642
"322","42101034802","Census Tract 348.02, Philadelphia County, Pennsylvania",5675,3684,1308,21,0,59,439,164,52519,3653,1334,215,243,601,367,103,0,2493,2309,184,2309,1271,1038
"323","42101980500","Census Tract 9805, Philadelphia County, Pennsylvania",0,0,0,0,0,0,0,0,NA,0,0,0,0,0,0,0,0,0,0,0,0,0,0
"324","42101022000","Census Tract 220, Philadelphia County, Pennsylvania",1481,1100,168,0,105,4,104,0,91146,1367,217,6,156,378,228,89,23,851,769,82,769,460,309
"325","42101038200","Census Tract 382, Philadelphia County, Pennsylvania",3167,1942,490,3,25,0,482,225,39317,2022,1012,105,18,175,24,40,0,1367,1224,143,1224,852,372
"326","42101017100","Census Tract 171, Philadelphia County, Pennsylvania",3517,0,3230,0,27,0,103,157,26751,2850,1231,101,353,191,59,0,0,1920,1621,299,1621,890,731
"327","42101020900","Census Tract 209, Philadelphia County, Pennsylvania",3172,2502,407,26,145,0,17,75,95605,2576,337,9,72,1113,472,125,39,1517,1427,90,1427,628,799
"328","42101025700","Census Tract 257, Philadelphia County, Pennsylvania",3924,1989,1586,7,93,0,89,160,56958,3163,191,49,198,819,869,183,137,2262,2175,87,2175,594,1581
"329","42101027200","Census Tract 272, Philadelphia County, Pennsylvania",4556,249,3416,15,77,0,162,637,58543,3235,922,47,364,646,243,10,42,2073,1862,211,1862,1262,600
"330","42101020300","Census Tract 203, Philadelphia County, Pennsylvania",2931,88,2661,0,38,0,108,36,28542,1949,807,182,188,52,21,38,0,1407,1164,243,1164,558,606
"331","42101011700","Census Tract 117, Philadelphia County, Pennsylvania",1934,849,737,0,267,0,0,81,87708,732,144,14,32,170,159,9,31,418,360,58,360,298,62
"332","42101019700","Census Tract 197, Philadelphia County, Pennsylvania",6971,1670,1647,41,193,137,2894,389,33331,4310,1245,270,97,225,0,0,0,2403,2264,139,2264,1165,1099
"333","42101034702","Census Tract 347.02, Philadelphia County, Pennsylvania",3551,2765,299,0,225,0,220,42,93397,2737,818,38,169,701,222,44,20,1420,1386,34,1386,1212,174
"334","42101033702","Census Tract 337.02, Philadelphia County, Pennsylvania",4536,2369,620,36,1250,0,261,0,72696,3419,1223,171,214,804,355,13,27,1844,1741,103,1741,1247,494
"335","42101039002","Census Tract 390.02, Philadelphia County, Pennsylvania",4303,1765,1097,22,118,57,314,930,55965,2843,1007,50,73,486,357,0,0,1772,1622,150,1622,1485,137
"336","42101017202","Census Tract 172.02, Philadelphia County, Pennsylvania",4500,15,4436,47,0,0,0,2,34574,3039,1516,86,112,172,109,0,0,2016,1685,331,1685,1061,624
"337","42101037800","Census Tract 378, Philadelphia County, Pennsylvania",2253,2008,0,32,55,0,83,75,62411,1906,409,97,146,429,353,67,0,1203,1133,70,1133,659,474
"338","42101989100","Census Tract 9891, Philadelphia County, Pennsylvania",1749,241,1272,34,27,0,34,141,NA,1207,344,143,22,18,0,0,0,0,0,0,0,0,0
"339","42101019100","Census Tract 191, Philadelphia County, Pennsylvania",8014,2327,1199,69,753,0,2416,1250,42889,5064,2097,267,250,529,147,263,0,2859,2777,82,2777,2233,544
"340","42101030000","Census Tract 300, Philadelphia County, Pennsylvania",8024,2892,3195,0,77,0,1084,776,31667,4750,1891,329,101,437,204,38,0,2952,2618,334,2618,1354,1264
"341","42101005400","Census Tract 54, Philadelphia County, Pennsylvania",1578,342,1130,0,69,0,9,28,65341,1154,178,0,88,245,99,7,13,773,738,35,738,252,486
"342","42101020702","Census Tract 207.02, Philadelphia County, Pennsylvania",1834,1337,307,0,142,0,22,26,210322,1092,31,0,56,222,556,25,120,685,661,24,661,454,207
"343","42101029900","Census Tract 299, Philadelphia County, Pennsylvania",4372,499,2350,128,56,0,1052,287,28398,2595,1244,158,247,105,29,0,35,1702,1449,253,1449,570,879
"344","42101980002","Census Tract 9800.02, Philadelphia County, Pennsylvania",23,0,11,0,0,0,12,0,NA,0,0,0,0,0,0,0,0,0,0,0,0,0,0
"345","42101003300","Census Tract 33, Philadelphia County, Pennsylvania",6373,3375,2144,0,500,0,172,182,58186,4446,1479,138,199,275,289,56,411,3100,2444,656,2444,956,1488
"346","42101017702","Census Tract 177.02, Philadelphia County, Pennsylvania",4706,1144,876,19,128,13,2441,85,27103,2647,906,139,205,125,23,0,11,1857,1535,322,1535,759,776
"347","42101018002","Census Tract 180.02, Philadelphia County, Pennsylvania",5987,4740,76,1,93,0,100,977,70610,4299,1617,242,391,526,324,114,16,2547,2438,109,2438,1801,637
"348","42101026100","Census Tract 261, Philadelphia County, Pennsylvania",2888,68,2785,0,0,0,0,35,46147,2101,667,56,186,277,172,58,37,1528,1394,134,1394,942,452
"349","42101980400","Census Tract 9804, Philadelphia County, Pennsylvania",0,0,0,0,0,0,0,0,NA,0,0,0,0,0,0,0,0,0,0,0,0,0,0
"350","42101027500","Census Tract 275, Philadelphia County, Pennsylvania",4913,564,3655,0,157,0,295,242,52989,3285,1167,182,395,452,151,0,8,1805,1683,122,1683,1237,446
"351","42101034600","Census Tract 346, Philadelphia County, Pennsylvania",2573,1233,826,5,133,0,266,110,50346,2002,696,29,105,451,61,0,49,1345,1279,66,1279,305,974
"352","42101013601","Census Tract 136.01, Philadelphia County, Pennsylvania",2981,2297,230,0,227,0,31,196,110455,2582,72,0,88,979,649,323,187,1632,1558,74,1558,937,621
"353","42101980905","Census Tract 9809.05, Philadelphia County, Pennsylvania",0,0,0,0,0,0,0,0,NA,0,0,0,0,0,0,0,0,0,0,0,0,0,0
"354","42101029400","Census Tract 294, Philadelphia County, Pennsylvania",4158,1020,1823,0,287,0,736,292,21525,2022,747,299,56,21,29,0,0,1421,1343,78,1343,525,818
"355","42101036303","Census Tract 363.03, Philadelphia County, Pennsylvania",6881,6495,178,0,51,0,74,83,102316,4647,1894,105,255,667,403,150,26,2505,2312,193,2312,2182,130
"356","42101009100","Census Tract 91, Philadelphia County, Pennsylvania",2901,958,880,0,814,0,63,186,35521,2035,239,195,95,518,394,65,125,2119,1641,478,1641,262,1379
"357","42101033500","Census Tract 335, Philadelphia County, Pennsylvania",4041,1538,906,0,784,0,437,376,54063,2679,1023,141,165,441,145,24,10,1519,1466,53,1466,747,719
"358","42101034801","Census Tract 348.01, Philadelphia County, Pennsylvania",4811,4203,283,0,210,0,59,56,65357,3746,1819,119,372,378,182,96,23,2116,2106,10,2106,1111,995
"359","42101018300","Census Tract 183, Philadelphia County, Pennsylvania",4042,3867,3,1,23,0,55,93,68095,3009,1485,73,203,304,278,34,0,1751,1596,155,1596,1429,167
"360","42101013200","Census Tract 132, Philadelphia County, Pennsylvania",2913,895,1536,0,168,0,208,106,38639,2200,472,102,23,621,151,111,13,1491,1405,86,1405,214,1191
"361","42101026000","Census Tract 260, Philadelphia County, Pennsylvania",3297,87,3114,13,0,6,0,77,58981,2535,784,22,224,457,426,33,0,1317,1317,0,1317,1020,297
"362","42101033102","Census Tract 331.02, Philadelphia County, Pennsylvania",3910,2823,355,0,41,0,0,691,52697,2704,818,76,292,481,298,9,4,1690,1491,199,1491,750,741
"363","42101003800","Census Tract 38, Philadelphia County, Pennsylvania",3914,3508,46,0,210,0,0,150,84132,2889,950,77,182,551,229,62,32,1729,1647,82,1647,1344,303
"364","42101001001","Census Tract 10.01, Philadelphia County, Pennsylvania",2809,2571,5,0,97,9,9,118,118102,2506,124,0,6,1060,515,349,256,1868,1659,209,1659,1058,601
"365","42101038600","Census Tract 386, Philadelphia County, Pennsylvania",1437,1107,201,0,54,0,5,70,144531,1065,37,20,49,364,221,163,158,604,589,15,589,451,138
"366","42101001400","Census Tract 14, Philadelphia County, Pennsylvania",4227,2852,802,0,220,0,80,273,103239,3254,187,202,30,986,568,367,289,2337,2004,333,2004,1078,926
"367","42101017800","Census Tract 178, Philadelphia County, Pennsylvania",5962,1905,2114,29,46,0,1307,561,36712,4077,844,386,68,557,196,0,0,3049,2627,422,2627,1242,1385
"368","42101004201","Census Tract 42.01, Philadelphia County, Pennsylvania",4985,3853,27,5,928,0,33,139,78065,3941,1066,156,140,938,123,151,0,2367,2176,191,2176,1731,445
"369","42101008601","Census Tract 86.01, Philadelphia County, Pennsylvania",3567,1946,932,17,197,0,125,350,64702,2619,251,129,56,786,516,28,403,1805,1537,268,1537,350,1187
"370","42101020600","Census Tract 206, Philadelphia County, Pennsylvania",1825,1130,420,5,83,0,50,137,55774,1234,164,75,94,286,346,79,27,1036,885,151,885,262,623
"371","42101016600","Census Tract 166, Philadelphia County, Pennsylvania",2219,234,1610,0,330,0,4,41,46221,1392,483,37,109,68,122,0,0,828,730,98,730,205,525
"372","42101016100","Census Tract 161, Philadelphia County, Pennsylvania",5924,3745,388,131,943,0,323,394,91553,4632,857,67,141,1418,828,199,137,2930,2598,332,2598,1326,1272
"373","42101011900","Census Tract 119, Philadelphia County, Pennsylvania",5159,264,4752,11,0,0,20,112,45433,3540,1151,18,110,414,223,125,0,2586,2126,460,2126,1207,919
"374","42101028300","Census Tract 283, Philadelphia County, Pennsylvania",6669,588,5618,0,222,0,0,241,22297,3808,1624,307,72,200,87,36,5,2925,2532,393,2532,1261,1271
"375","42101000805","Census Tract 8.05, Philadelphia County, Pennsylvania",2532,1817,43,0,463,0,59,150,80772,2224,16,0,0,843,566,486,233,2396,1847,549,1847,419,1428
"376","42101023500","Census Tract 235, Philadelphia County, Pennsylvania",1299,827,426,0,6,0,0,40,106587,1005,59,10,13,265,210,184,45,628,595,33,595,423,172
"377","42101037900","Census Tract 379, Philadelphia County, Pennsylvania",4763,4437,8,10,0,0,74,234,55517,4004,1341,179,301,648,438,37,0,2521,2384,137,2384,1698,686
"378","42101010400","Census Tract 104, Philadelphia County, Pennsylvania",3617,161,2904,0,0,0,458,94,21700,2359,1048,165,109,126,66,0,0,1966,1540,426,1540,519,1021
"379","42101980300","Census Tract 9803, Philadelphia County, Pennsylvania",0,0,0,0,0,0,0,0,NA,0,0,0,0,0,0,0,0,0,0,0,0,0,0
"380","42101016500","Census Tract 165, Philadelphia County, Pennsylvania",3061,125,2772,0,43,0,17,104,21010,2131,861,67,147,230,58,0,0,1432,1087,345,1087,299,788
"381","42101036302","Census Tract 363.02, Philadelphia County, Pennsylvania",3750,2848,572,0,0,0,179,151,65612,2565,800,107,129,253,248,78,52,1346,1346,0,1346,973,373
"382","42101008802","Census Tract 88.02, Philadelphia County, Pennsylvania",5766,2545,1517,0,1355,0,55,294,17465,1002,74,19,67,225,254,52,163,1892,1406,486,1406,92,1314
"383","42101039001","Census Tract 390.01, Philadelphia County, Pennsylvania",4057,786,1900,0,42,0,879,450,33711,2294,1072,316,144,187,38,31,0,1315,1251,64,1251,576,675
"384","42101010100","Census Tract 101, Philadelphia County, Pennsylvania",5633,34,5506,24,0,0,0,69,46467,3958,1343,248,55,286,46,125,102,2978,2287,691,2287,1358,929
"385","42101026600","Census Tract 266, Philadelphia County, Pennsylvania",6836,36,6534,0,0,0,1,265,47451,4727,1514,278,399,457,186,0,60,2854,2614,240,2614,1940,674
"386","42101036000","Census Tract 360, Philadelphia County, Pennsylvania",3474,1918,554,0,822,0,34,146,56250,2793,807,80,225,716,232,66,46,1321,1291,30,1291,752,539
"387","42101034400","Census Tract 344, Philadelphia County, Pennsylvania",7965,5682,725,0,1149,0,101,308,90797,6214,1815,194,390,1226,717,65,112,3063,2979,84,2979,2685,294
"388","42101003600","Census Tract 36, Philadelphia County, Pennsylvania",6918,1268,4273,90,1069,0,94,124,37597,4272,1656,364,234,423,147,10,0,2749,2567,182,2567,1410,1157
"389","42101021000","Census Tract 210, Philadelphia County, Pennsylvania",5422,4780,420,0,151,0,26,45,79264,4212,610,6,214,1656,352,102,54,2646,2489,157,2489,1217,1272
"390","42101001002","Census Tract 10.02, Philadelphia County, Pennsylvania",3693,3207,31,0,333,0,0,122,169531,3047,23,12,68,1207,672,553,255,2486,2046,440,2046,1445,601
"391","42101032000","Census Tract 320, Philadelphia County, Pennsylvania",8523,4556,1456,0,132,0,2046,333,54142,4877,1816,362,324,522,180,27,0,2704,2595,109,2595,1596,999
"392","42101980904","Census Tract 9809.04, Philadelphia County, Pennsylvania",0,0,0,0,0,0,0,0,NA,0,0,0,0,0,0,0,0,0,0,0,0,0,0
"393","42101023600","Census Tract 236, Philadelphia County, Pennsylvania",2330,1369,715,0,14,0,78,154,104318,1812,286,10,37,300,503,390,142,1273,1118,155,1118,767,351
"394","42101030100","Census Tract 301, Philadelphia County, Pennsylvania",5645,1291,2528,0,396,0,1215,215,21990,4097,1326,192,228,631,223,55,19,2687,2368,319,2368,1134,1234
"395","42101010600","Census Tract 106, Philadelphia County, Pennsylvania",1674,112,1339,80,96,0,0,47,22647,1120,442,49,92,77,36,0,0,853,638,215,638,163,475
"396","42101015200","Census Tract 152, Philadelphia County, Pennsylvania",5436,366,4673,10,107,0,0,280,49581,3482,1510,311,112,424,59,0,35,2641,2179,462,2179,650,1529
"397","42101036203","Census Tract 362.03, Philadelphia County, Pennsylvania",4842,4249,126,103,260,0,87,17,73063,3629,1307,55,283,817,154,16,13,1930,1847,83,1847,1617,230
"398","42101031102","Census Tract 311.02, Philadelphia County, Pennsylvania",4560,859,2166,144,164,0,1028,199,49787,2564,763,163,198,234,117,0,26,1474,1372,102,1372,908,464
"399","42101016901","Census Tract 169.01, Philadelphia County, Pennsylvania",3203,76,2973,0,37,0,117,0,24699,2233,959,198,8,214,44,0,0,1618,1208,410,1208,674,534
"400","42101014201","Census Tract 142.01, Philadelphia County, Pennsylvania",3680,2963,307,26,179,0,0,205,116574,3076,297,0,91,1368,543,186,201,1722,1687,35,1687,657,1030
"401","42101029800","Census Tract 298, Philadelphia County, Pennsylvania",5204,1660,2258,0,212,0,899,175,36563,3253,1399,240,245,151,58,0,27,2156,1948,208,1948,1079,869
"402","42101002702","Census Tract 27.02, Philadelphia County, Pennsylvania",4484,3590,292,0,86,0,76,440,80075,3507,694,97,291,1184,407,95,47,2131,1933,198,1933,1345,588
"403","42101006400","Census Tract 64, Philadelphia County, Pennsylvania",4711,291,3954,139,158,0,31,138,32191,2671,782,114,280,319,58,0,4,1714,1630,84,1630,994,636
"404","42101012000","Census Tract 120, Philadelphia County, Pennsylvania",2130,613,1127,0,166,0,36,188,69500,1203,212,11,142,215,218,102,51,732,642,90,642,327,315
"405","42101007800","Census Tract 78, Philadelphia County, Pennsylvania",4232,2426,875,0,595,34,86,216,55200,3249,494,41,125,870,916,157,173,2307,2130,177,2130,516,1614
"406","42101027300","Census Tract 273, Philadelphia County, Pennsylvania",5749,477,3658,43,975,0,272,324,45680,4506,1143,417,214,453,66,40,71,2388,2388,0,2388,1585,803
"407","42101001700","Census Tract 17, Philadelphia County, Pennsylvania",3029,2262,119,0,87,0,8,553,129300,2216,76,2,120,657,588,416,220,1564,1388,176,1388,922,466
"408","42101002500","Census Tract 25, Philadelphia County, Pennsylvania",4420,2496,1002,145,617,0,27,133,67548,3225,616,163,143,893,495,200,61,2108,2023,85,2023,1117,906
